Cod;Dpto;Edad;Total;Hombres;Mujeres
100;CHUQUISACA;0;13458;6886;6572
101;CHUQUISACA;1;13336;6820;6516
102;CHUQUISACA;2;13249;6776;6473
103;CHUQUISACA;3;13180;6739;6441
104;CHUQUISACA;4;13113;6705;6408
105;CHUQUISACA;5;13049;6670;6379
106;CHUQUISACA;6;12999;6644;6355
107;CHUQUISACA;7;12948;6614;6334
108;CHUQUISACA;8;12910;6593;6317
109;CHUQUISACA;9;12882;6577;6305
110;CHUQUISACA;10;12999;6662;6337
111;CHUQUISACA;11;13215;6750;6465
112;CHUQUISACA;12;13350;6803;6547
113;CHUQUISACA;13;13423;6827;6596
114;CHUQUISACA;14;13420;6823;6597
115;CHUQUISACA;15;13364;6802;6562
116;CHUQUISACA;16;13245;6751;6494
117;CHUQUISACA;17;13125;6708;6417
118;CHUQUISACA;18;13027;6669;6358
119;CHUQUISACA;19;12975;6646;6329
120;CHUQUISACA;20;12934;6627;6307
121;CHUQUISACA;21;12960;6640;6320
122;CHUQUISACA;22;12886;6596;6290
123;CHUQUISACA;23;12688;6499;6189
124;CHUQUISACA;24;12407;6354;6053
125;CHUQUISACA;25;12089;6188;5901
126;CHUQUISACA;26;11756;6006;5750
127;CHUQUISACA;27;11355;5781;5574
128;CHUQUISACA;28;10930;5543;5387
129;CHUQUISACA;29;10546;5327;5219
130;CHUQUISACA;30;10083;5075;5008
131;CHUQUISACA;31;9642;4842;4800
132;CHUQUISACA;32;9234;4626;4608
133;CHUQUISACA;33;8870;4434;4436
134;CHUQUISACA;34;8560;4273;4287
135;CHUQUISACA;35;8284;4129;4155
136;CHUQUISACA;36;8037;3999;4038
137;CHUQUISACA;37;7803;3876;3927
138;CHUQUISACA;38;7580;3757;3823
139;CHUQUISACA;39;7363;3639;3724
140;CHUQUISACA;40;7156;3528;3628
141;CHUQUISACA;41;6959;3423;3536
142;CHUQUISACA;42;6777;3325;3452
143;CHUQUISACA;43;6610;3236;3374
144;CHUQUISACA;44;6468;3160;3308
145;CHUQUISACA;45;6336;3093;3243
146;CHUQUISACA;46;6207;3022;3185
147;CHUQUISACA;47;6066;2948;3118
148;CHUQUISACA;48;5913;2864;3049
149;CHUQUISACA;49;5742;2775;2967
150;CHUQUISACA;50;5569;2678;2891
151;CHUQUISACA;51;5385;2582;2803
152;CHUQUISACA;52;5230;2496;2734
153;CHUQUISACA;53;5094;2424;2670
154;CHUQUISACA;54;4970;2361;2609
155;CHUQUISACA;55;4858;2305;2553
156;CHUQUISACA;56;4746;2248;2498
157;CHUQUISACA;57;4619;2185;2434
158;CHUQUISACA;58;4480;2113;2367
159;CHUQUISACA;59;4333;2040;2293
160;CHUQUISACA;60;4198;1972;2226
161;CHUQUISACA;61;4051;1898;2153
162;CHUQUISACA;62;3913;1829;2084
163;CHUQUISACA;63;3766;1761;2005
164;CHUQUISACA;64;3632;1696;1936
165;CHUQUISACA;65;3496;1634;1862
166;CHUQUISACA;66;3375;1576;1799
167;CHUQUISACA;67;3276;1530;1746
168;CHUQUISACA;68;3191;1489;1702
169;CHUQUISACA;69;3120;1452;1668
170;CHUQUISACA;70;3080;1431;1649
171;CHUQUISACA;71;3017;1400;1617
172;CHUQUISACA;72;2930;1356;1574
173;CHUQUISACA;73;2836;1310;1526
174;CHUQUISACA;74;2704;1247;1457
175;CHUQUISACA;75;2579;1183;1396
176;CHUQUISACA;76;2471;1132;1339
177;CHUQUISACA;77;2344;1062;1282
178;CHUQUISACA;78;2212;994;1218
179;CHUQUISACA;79;2066;922;1144
180;CHUQUISACA;80;16070;6640;9430
200;LA PAZ;0;53942;27619;26323
201;LA PAZ;1;53764;27489;26275
202;LA PAZ;2;53713;27422;26291
203;LA PAZ;3;53811;27444;26367
204;LA PAZ;4;53973;27506;26467
205;LA PAZ;5;54174;27587;26587
206;LA PAZ;6;54394;27685;26709
207;LA PAZ;7;54626;27790;26836
208;LA PAZ;8;54885;27911;26974
209;LA PAZ;9;55154;28040;27114
210;LA PAZ;10;55703;28278;27425
211;LA PAZ;11;56092;28494;27598
212;LA PAZ;12;56480;28720;27760
213;LA PAZ;13;56716;28855;27861
214;LA PAZ;14;56823;28923;27900
215;LA PAZ;15;56833;28930;27903
216;LA PAZ;16;56617;28812;27805
217;LA PAZ;17;56320;28630;27690
218;LA PAZ;18;55865;28347;27518
219;LA PAZ;19;55327;28014;27313
220;LA PAZ;20;54734;27667;27067
221;LA PAZ;21;53998;27242;26756
222;LA PAZ;22;53269;26836;26433
223;LA PAZ;23;52530;26420;26110
224;LA PAZ;24;51798;26003;25795
225;LA PAZ;25;51047;25572;25475
226;LA PAZ;26;50223;25118;25105
227;LA PAZ;27;49216;24596;24620
228;LA PAZ;28;48342;24169;24173
229;LA PAZ;29;47876;23961;23915
230;LA PAZ;30;47246;23650;23596
231;LA PAZ;31;46202;23111;23091
232;LA PAZ;32;45228;22586;22642
233;LA PAZ;33;44416;22150;22266
234;LA PAZ;34;43708;21768;21940
235;LA PAZ;35;43002;21401;21601
236;LA PAZ;36;42253;21004;21249
237;LA PAZ;37;41515;20617;20898
238;LA PAZ;38;40791;20235;20556
239;LA PAZ;39;40067;19844;20223
240;LA PAZ;40;39368;19471;19897
241;LA PAZ;41;38721;19117;19604
242;LA PAZ;42;37985;18720;19265
243;LA PAZ;43;37154;18277;18877
244;LA PAZ;44;36254;17802;18452
245;LA PAZ;45;35343;17321;18022
246;LA PAZ;46;34441;16847;17594
247;LA PAZ;47;33580;16398;17182
248;LA PAZ;48;32795;15990;16805
249;LA PAZ;49;32063;15618;16445
250;LA PAZ;50;31346;15256;16090
251;LA PAZ;51;30511;14833;15678
252;LA PAZ;52;29618;14389;15229
253;LA PAZ;53;28652;13904;14748
254;LA PAZ;54;27634;13388;14246
255;LA PAZ;55;26614;12872;13742
256;LA PAZ;56;25623;12376;13247
257;LA PAZ;57;24695;11913;12782
258;LA PAZ;58;23859;11501;12358
259;LA PAZ;59;23088;11118;11970
260;LA PAZ;60;22362;10767;11595
261;LA PAZ;61;21557;10372;11185
262;LA PAZ;62;20796;9997;10799
263;LA PAZ;63;19969;9586;10383
264;LA PAZ;64;19163;9187;9976
265;LA PAZ;65;18371;8794;9577
266;LA PAZ;66;17623;8419;9204
267;LA PAZ;67;16931;8069;8862
268;LA PAZ;68;16313;7754;8559
269;LA PAZ;69;15730;7455;8275
270;LA PAZ;70;15231;7200;8031
271;LA PAZ;71;14661;6918;7743
272;LA PAZ;72;13999;6593;7406
273;LA PAZ;73;13361;6278;7083
274;LA PAZ;74;12587;5896;6691
275;LA PAZ;75;11857;5535;6322
276;LA PAZ;76;11211;5210;6001
277;LA PAZ;77;10478;4842;5636
278;LA PAZ;78;9682;4444;5238
279;LA PAZ;79;8845;4033;4812
280;LA PAZ;80;59203;24232;34971
300;COCHABAMBA;0;41711;21339;20372
301;COCHABAMBA;1;41376;21164;20212
302;COCHABAMBA;2;41143;21047;20096
303;COCHABAMBA;3;40986;20969;20017
304;COCHABAMBA;4;40846;20899;19947
305;COCHABAMBA;5;40700;20823;19877
306;COCHABAMBA;6;40543;20742;19801
307;COCHABAMBA;7;40385;20660;19725
308;COCHABAMBA;8;40219;20573;19646
309;COCHABAMBA;9;40046;20485;19561
310;COCHABAMBA;10;40373;20670;19703
311;COCHABAMBA;11;40644;20787;19857
312;COCHABAMBA;12;40874;20879;19995
313;COCHABAMBA;13;41030;20936;20094
314;COCHABAMBA;14;41100;20950;20150
315;COCHABAMBA;15;41144;20944;20200
316;COCHABAMBA;16;41060;20875;20185
317;COCHABAMBA;17;40963;20788;20175
318;COCHABAMBA;18;40814;20680;20134
319;COCHABAMBA;19;40623;20544;20079
320;COCHABAMBA;20;40403;20399;20004
321;COCHABAMBA;21;40067;20204;19863
322;COCHABAMBA;22;39695;19992;19703
323;COCHABAMBA;23;39274;19758;19516
324;COCHABAMBA;24;38794;19499;19295
325;COCHABAMBA;25;38242;19212;19030
326;COCHABAMBA;26;37567;18860;18707
327;COCHABAMBA;27;36691;18417;18274
328;COCHABAMBA;28;35820;17972;17848
329;COCHABAMBA;29;35178;17641;17537
330;COCHABAMBA;30;34424;17244;17180
331;COCHABAMBA;31;33497;16759;16738
332;COCHABAMBA;32;32564;16269;16295
333;COCHABAMBA;33;31626;15772;15854
334;COCHABAMBA;34;30696;15277;15419
335;COCHABAMBA;35;29823;14816;15007
336;COCHABAMBA;36;28998;14378;14620
337;COCHABAMBA;37;28193;13958;14235
338;COCHABAMBA;38;27419;13554;13865
339;COCHABAMBA;39;26655;13160;13495
340;COCHABAMBA;40;25904;12770;13134
341;COCHABAMBA;41;25130;12367;12763
342;COCHABAMBA;42;24362;11971;12391
343;COCHABAMBA;43;23593;11574;12019
344;COCHABAMBA;44;22830;11178;11652
345;COCHABAMBA;45;22050;10774;11276
346;COCHABAMBA;46;21265;10367;10898
347;COCHABAMBA;47;20469;9953;10516
348;COCHABAMBA;48;19668;9540;10128
349;COCHABAMBA;49;18857;9125;9732
350;COCHABAMBA;50;18042;8712;9330
351;COCHABAMBA;51;17406;8389;9017
352;COCHABAMBA;52;16808;8091;8717
353;COCHABAMBA;53;16272;7824;8448
354;COCHABAMBA;54;15779;7586;8193
355;COCHABAMBA;55;15326;7367;7959
356;COCHABAMBA;56;14899;7158;7741
357;COCHABAMBA;57;14463;6941;7522
358;COCHABAMBA;58;14018;6715;7303
359;COCHABAMBA;59;13565;6484;7081
360;COCHABAMBA;60;13135;6265;6870
361;COCHABAMBA;61;12685;6038;6647
362;COCHABAMBA;62;12290;5837;6453
363;COCHABAMBA;63;11915;5648;6267
364;COCHABAMBA;64;11587;5479;6108
365;COCHABAMBA;65;11288;5323;5965
366;COCHABAMBA;66;10979;5162;5817
367;COCHABAMBA;67;10658;4995;5663
368;COCHABAMBA;68;10315;4817;5498
369;COCHABAMBA;69;9937;4623;5314
370;COCHABAMBA;70;9588;4446;5142
371;COCHABAMBA;71;9215;4255;4960
372;COCHABAMBA;72;8791;4045;4746
373;COCHABAMBA;73;8420;3857;4563
374;COCHABAMBA;74;7974;3633;4341
375;COCHABAMBA;75;7558;3424;4134
376;COCHABAMBA;76;7183;3228;3955
377;COCHABAMBA;77;6760;3015;3745
378;COCHABAMBA;78;6303;2787;3516
379;COCHABAMBA;79;5808;2546;3262
380;COCHABAMBA;80;41811;17169;24642
400;ORURO;0;9458;4845;4613
401;ORURO;1;9497;4868;4629
402;ORURO;2;9573;4912;4661
403;ORURO;3;9669;4968;4701
404;ORURO;4;9778;5030;4748
405;ORURO;5;9895;5097;4798
406;ORURO;6;10020;5163;4857
407;ORURO;7;10144;5230;4914
408;ORURO;8;10266;5299;4967
409;ORURO;9;10379;5362;5017
410;ORURO;10;10468;5419;5049
411;ORURO;11;10533;5452;5081
412;ORURO;12;10577;5476;5101
413;ORURO;13;10602;5491;5111
414;ORURO;14;10586;5495;5091
415;ORURO;15;10536;5494;5042
416;ORURO;16;10438;5474;4964
417;ORURO;17;10322;5448;4874
418;ORURO;18;10186;5411;4775
419;ORURO;19;10064;5366;4698
420;ORURO;20;9949;5315;4634
421;ORURO;21;9804;5240;4564
422;ORURO;22;9653;5161;4492
423;ORURO;23;9497;5080;4417
424;ORURO;24;9345;5001;4344
425;ORURO;25;9200;4913;4287
426;ORURO;26;9055;4820;4235
427;ORURO;27;8863;4700;4163
428;ORURO;28;8677;4589;4088
429;ORURO;29;8542;4513;4029
430;ORURO;30;8353;4421;3932
431;ORURO;31;8238;4364;3874
432;ORURO;32;8127;4307;3820
433;ORURO;33;8022;4245;3777
434;ORURO;34;7924;4178;3746
435;ORURO;35;7840;4110;3730
436;ORURO;36;7773;4045;3728
437;ORURO;37;7709;3979;3730
438;ORURO;38;7651;3918;3733
439;ORURO;39;7597;3858;3739
440;ORURO;40;7543;3802;3741
441;ORURO;41;7339;3680;3659
442;ORURO;42;7123;3556;3567
443;ORURO;43;6911;3438;3473
444;ORURO;44;6694;3318;3376
445;ORURO;45;6485;3202;3283
446;ORURO;46;6268;3080;3188
447;ORURO;47;6054;2965;3089
448;ORURO;48;5831;2845;2986
449;ORURO;49;5597;2726;2871
450;ORURO;50;5362;2608;2754
451;ORURO;51;5227;2538;2689
452;ORURO;52;5081;2464;2617
453;ORURO;53;4931;2387;2544
454;ORURO;54;4775;2306;2469
455;ORURO;55;4606;2221;2385
456;ORURO;56;4438;2140;2298
457;ORURO;57;4271;2057;2214
458;ORURO;58;4115;1979;2136
459;ORURO;59;3961;1900;2061
460;ORURO;60;3808;1822;1986
461;ORURO;61;3650;1745;1905
462;ORURO;62;3563;1701;1862
463;ORURO;63;3473;1656;1817
464;ORURO;64;3381;1608;1773
465;ORURO;65;3290;1562;1728
466;ORURO;66;3199;1516;1683
467;ORURO;67;3100;1465;1635
468;ORURO;68;2994;1412;1582
469;ORURO;69;2873;1351;1522
470;ORURO;70;2756;1297;1459
471;ORURO;71;2634;1233;1401
472;ORURO;72;2494;1166;1328
473;ORURO;73;2371;1105;1266
474;ORURO;74;2233;1037;1196
475;ORURO;75;2102;975;1127
476;ORURO;76;1988;916;1072
477;ORURO;77;1854;848;1006
478;ORURO;78;1717;781;936
479;ORURO;79;1566;708;858
480;ORURO;80;10620;4576;6044
500;POTOSI;0;20016;10238;9778
501;POTOSI;1;19645;10047;9598
502;POTOSI;2;19347;9897;9450
503;POTOSI;3;19110;9778;9332
504;POTOSI;4;18905;9676;9229
505;POTOSI;5;18721;9583;9138
506;POTOSI;6;18563;9502;9061
507;POTOSI;7;18432;9431;9001
508;POTOSI;8;18330;9377;8953
509;POTOSI;9;18273;9346;8927
510;POTOSI;10;18507;9480;9027
511;POTOSI;11;18810;9630;9180
512;POTOSI;12;19072;9760;9312
513;POTOSI;13;19256;9854;9402
514;POTOSI;14;19370;9917;9453
515;POTOSI;15;19414;9947;9467
516;POTOSI;16;19333;9920;9413
517;POTOSI;17;19184;9853;9331
518;POTOSI;18;18953;9743;9210
519;POTOSI;19;18654;9589;9065
520;POTOSI;20;18331;9417;8914
521;POTOSI;21;18142;9320;8822
522;POTOSI;22;17776;9135;8641
523;POTOSI;23;17190;8827;8363
524;POTOSI;24;16460;8441;8019
525;POTOSI;25;15742;8059;7683
526;POTOSI;26;15073;7699;7374
527;POTOSI;27;14341;7305;7036
528;POTOSI;28;13653;6941;6712
529;POTOSI;29;13099;6648;6451
530;POTOSI;30;12446;6309;6137
531;POTOSI;31;11886;6023;5863
532;POTOSI;32;11454;5802;5652
533;POTOSI;33;11218;5687;5531
534;POTOSI;34;11108;5642;5466
535;POTOSI;35;11026;5606;5420
536;POTOSI;36;10896;5549;5347
537;POTOSI;37;10737;5470;5267
538;POTOSI;38;10545;5370;5175
539;POTOSI;39;10320;5252;5068
540;POTOSI;40;10112;5139;4973
541;POTOSI;41;9948;5048;4900
542;POTOSI;42;9730;4928;4802
543;POTOSI;43;9471;4787;4684
544;POTOSI;44;9171;4621;4550
545;POTOSI;45;8862;4452;4410
546;POTOSI;46;8573;4288;4285
547;POTOSI;47;8304;4138;4166
548;POTOSI;48;8041;3993;4048
549;POTOSI;49;7809;3866;3943
550;POTOSI;50;7576;3736;3840
551;POTOSI;51;7324;3602;3722
552;POTOSI;52;7101;3479;3622
553;POTOSI;53;6908;3375;3533
554;POTOSI;54;6744;3285;3459
555;POTOSI;55;6589;3198;3391
556;POTOSI;56;6441;3113;3328
557;POTOSI;57;6286;3022;3264
558;POTOSI;58;6109;2927;3182
559;POTOSI;59;5928;2824;3104
560;POTOSI;60;5751;2722;3029
561;POTOSI;61;5560;2617;2943
562;POTOSI;62;5397;2524;2873
563;POTOSI;63;5257;2438;2819
564;POTOSI;64;5151;2374;2777
565;POTOSI;65;5043;2310;2733
566;POTOSI;66;4938;2249;2689
567;POTOSI;67;4823;2186;2637
568;POTOSI;68;4708;2125;2583
569;POTOSI;69;4572;2055;2517
570;POTOSI;70;4463;1998;2465
571;POTOSI;71;4330;1937;2393
572;POTOSI;72;4154;1849;2305
573;POTOSI;73;3998;1772;2226
574;POTOSI;74;3774;1665;2109
575;POTOSI;75;3568;1569;1999
576;POTOSI;76;3381;1476;1905
577;POTOSI;77;3180;1377;1803
578;POTOSI;78;2959;1273;1686
579;POTOSI;79;2738;1169;1569
580;POTOSI;80;19977;8154;11823
600;TARIJA;0;11078;5670;5408
601;TARIJA;1;11117;5691;5426
602;TARIJA;2;11191;5730;5461
603;TARIJA;3;11269;5772;5497
604;TARIJA;4;11354;5816;5538
605;TARIJA;5;11441;5862;5579
606;TARIJA;6;11520;5899;5621
607;TARIJA;7;11603;5945;5658
608;TARIJA;8;11679;5984;5695
609;TARIJA;9;11754;6022;5732
610;TARIJA;10;11541;5926;5615
611;TARIJA;11;11470;5886;5584
612;TARIJA;12;11402;5846;5556
613;TARIJA;13;11335;5805;5530
614;TARIJA;14;11264;5767;5497
615;TARIJA;15;11187;5722;5465
616;TARIJA;16;11083;5663;5420
617;TARIJA;17;10974;5612;5362
618;TARIJA;18;10858;5561;5297
619;TARIJA;19;10717;5502;5215
620;TARIJA;20;10559;5432;5127
621;TARIJA;21;10487;5406;5081
622;TARIJA;22;10406;5370;5036
623;TARIJA;23;10320;5333;4987
624;TARIJA;24;10221;5290;4931
625;TARIJA;25;10122;5249;4873
626;TARIJA;26;10000;5195;4805
627;TARIJA;27;9825;5104;4721
628;TARIJA;28;9653;5006;4647
629;TARIJA;29;9566;4944;4622
630;TARIJA;30;9468;4878;4590
631;TARIJA;31;9346;4803;4543
632;TARIJA;32;9216;4729;4487
633;TARIJA;33;9078;4649;4429
634;TARIJA;34;8918;4557;4361
635;TARIJA;35;8748;4458;4290
636;TARIJA;36;8588;4367;4221
637;TARIJA;37;8424;4273;4151
638;TARIJA;38;8275;4186;4089
639;TARIJA;39;8124;4102;4022
640;TARIJA;40;7964;4016;3948
641;TARIJA;41;7767;3911;3856
642;TARIJA;42;7563;3803;3760
643;TARIJA;43;7371;3701;3670
644;TARIJA;44;7174;3598;3576
645;TARIJA;45;6981;3496;3485
646;TARIJA;46;6784;3396;3388
647;TARIJA;47;6587;3296;3291
648;TARIJA;48;6386;3190;3196
649;TARIJA;49;6184;3084;3100
650;TARIJA;50;5982;2978;3004
651;TARIJA;51;5793;2883;2910
652;TARIJA;52;5598;2783;2815
653;TARIJA;53;5394;2679;2715
654;TARIJA;54;5190;2575;2615
655;TARIJA;55;4982;2469;2513
656;TARIJA;56;4781;2366;2415
657;TARIJA;57;4580;2264;2316
658;TARIJA;58;4376;2159;2217
659;TARIJA;59;4179;2061;2118
660;TARIJA;60;3992;1965;2027
661;TARIJA;61;3800;1866;1934
662;TARIJA;62;3678;1797;1881
663;TARIJA;63;3530;1719;1811
664;TARIJA;64;3370;1632;1738
665;TARIJA;65;3211;1549;1662
666;TARIJA;66;3064;1470;1594
667;TARIJA;67;2926;1397;1529
668;TARIJA;68;2802;1331;1471
669;TARIJA;69;2680;1268;1412
670;TARIJA;70;2565;1207;1358
671;TARIJA;71;2443;1143;1300
672;TARIJA;72;2326;1082;1244
673;TARIJA;73;2220;1030;1190
674;TARIJA;74;2099;970;1129
675;TARIJA;75;1992;917;1075
676;TARIJA;76;1896;868;1028
677;TARIJA;77;1782;810;972
678;TARIJA;78;1661;751;910
679;TARIJA;79;1531;689;842
680;TARIJA;80;10849;4647;6202
700;SANTA CRUZ;0;71450;36554;34896
701;SANTA CRUZ;1;71337;36477;34860
702;SANTA CRUZ;2;71374;36481;34893
703;SANTA CRUZ;3;71470;36517;34953
704;SANTA CRUZ;4;71516;36530;34986
705;SANTA CRUZ;5;71514;36521;34993
706;SANTA CRUZ;6;71419;36465;34954
707;SANTA CRUZ;7;71245;36365;34880
708;SANTA CRUZ;8;70982;36221;34761
709;SANTA CRUZ;9;70669;36061;34608
710;SANTA CRUZ;10;69736;35544;34192
711;SANTA CRUZ;11;68507;34955;33552
712;SANTA CRUZ;12;67493;34451;33042
713;SANTA CRUZ;13;66672;34039;32633
714;SANTA CRUZ;14;65948;33640;32308
715;SANTA CRUZ;15;65386;33315;32071
716;SANTA CRUZ;16;64782;32953;31829
717;SANTA CRUZ;17;64248;32620;31628
718;SANTA CRUZ;18;63705;32285;31420
719;SANTA CRUZ;19;63134;31952;31182
720;SANTA CRUZ;20;62491;31590;30901
721;SANTA CRUZ;21;62256;31434;30822
722;SANTA CRUZ;22;62077;31303;30774
723;SANTA CRUZ;23;61993;31217;30776
724;SANTA CRUZ;24;61892;31131;30761
725;SANTA CRUZ;25;61680;30997;30683
726;SANTA CRUZ;26;61170;30734;30436
727;SANTA CRUZ;27;60179;30228;29951
728;SANTA CRUZ;28;59039;29636;29403
729;SANTA CRUZ;29;58174;29184;28990
730;SANTA CRUZ;30;57125;28639;28486
731;SANTA CRUZ;31;56354;28245;28109
732;SANTA CRUZ;32;55381;27753;27628
733;SANTA CRUZ;33;54124;27123;27001
734;SANTA CRUZ;34;52666;26395;26271
735;SANTA CRUZ;35;51148;25639;25509
736;SANTA CRUZ;36;49646;24904;24742
737;SANTA CRUZ;37;48127;24161;23966
738;SANTA CRUZ;38;46560;23402;23158
739;SANTA CRUZ;39;45014;22658;22356
740;SANTA CRUZ;40;43407;21882;21525
741;SANTA CRUZ;41;41853;21120;20733
742;SANTA CRUZ;42;40407;20407;20000
743;SANTA CRUZ;43;39062;19751;19311
744;SANTA CRUZ;44;37847;19159;18688
745;SANTA CRUZ;45;36658;18580;18078
746;SANTA CRUZ;46;35456;17993;17463
747;SANTA CRUZ;47;34235;17388;16847
748;SANTA CRUZ;48;32963;16754;16209
749;SANTA CRUZ;49;31682;16097;15585
750;SANTA CRUZ;50;30433;15468;14965
751;SANTA CRUZ;51;29128;14801;14327
752;SANTA CRUZ;52;27881;14173;13708
753;SANTA CRUZ;53;26716;13585;13131
754;SANTA CRUZ;54;25622;13033;12589
755;SANTA CRUZ;55;24588;12506;12082
756;SANTA CRUZ;56;23590;11995;11595
757;SANTA CRUZ;57;22638;11499;11139
758;SANTA CRUZ;58;21741;11030;10711
759;SANTA CRUZ;59;20891;10589;10302
760;SANTA CRUZ;60;20041;10142;9899
761;SANTA CRUZ;61;19173;9684;9489
762;SANTA CRUZ;62;18370;9262;9108
763;SANTA CRUZ;63;17548;8831;8717
764;SANTA CRUZ;64;16754;8418;8336
765;SANTA CRUZ;65;16021;8032;7989
766;SANTA CRUZ;66;15300;7662;7638
767;SANTA CRUZ;67;14578;7280;7298
768;SANTA CRUZ;68;13857;6898;6959
769;SANTA CRUZ;69;13128;6511;6617
770;SANTA CRUZ;70;12448;6157;6291
771;SANTA CRUZ;71;11730;5781;5949
772;SANTA CRUZ;72;10981;5399;5582
773;SANTA CRUZ;73;10287;5042;5245
774;SANTA CRUZ;74;9554;4657;4897
775;SANTA CRUZ;75;8837;4275;4562
776;SANTA CRUZ;76;8218;3947;4271
777;SANTA CRUZ;77;7568;3606;3962
778;SANTA CRUZ;78;6900;3250;3650
779;SANTA CRUZ;79;6248;2911;3337
780;SANTA CRUZ;80;41377;17663;23714
800;BENI;0;13308;6810;6498
801;BENI;1;13078;6685;6393
802;BENI;2;12888;6582;6306
803;BENI;3;12724;6498;6226
804;BENI;4;12565;6413;6152
805;BENI;5;12421;6339;6082
806;BENI;6;12289;6271;6018
807;BENI;7;12174;6215;5959
808;BENI;8;12073;6164;5909
809;BENI;9;11991;6123;5868
810;BENI;10;11923;6077;5846
811;BENI;11;11893;6071;5822
812;BENI;12;11859;6063;5796
813;BENI;13;11809;6046;5763
814;BENI;14;11718;6005;5713
815;BENI;15;11605;5953;5652
816;BENI;16;11435;5872;5563
817;BENI;17;11251;5788;5463
818;BENI;18;11022;5687;5335
819;BENI;19;10763;5578;5185
820;BENI;20;10483;5449;5034
821;BENI;21;10123;5277;4846
822;BENI;22;9764;5096;4668
823;BENI;23;9415;4913;4502
824;BENI;24;9095;4745;4350
825;BENI;25;8789;4583;4206
826;BENI;26;8502;4427;4075
827;BENI;27;8172;4247;3925
828;BENI;28;7887;4081;3806
829;BENI;29;7682;3955;3727
830;BENI;30;7476;3832;3644
831;BENI;31;7344;3746;3598
832;BENI;32;7202;3665;3537
833;BENI;33;7036;3577;3459
834;BENI;34;6836;3474;3362
835;BENI;35;6616;3364;3252
836;BENI;36;6382;3242;3140
837;BENI;37;6144;3119;3025
838;BENI;38;5901;2990;2911
839;BENI;39;5659;2862;2797
840;BENI;40;5414;2735;2679
841;BENI;41;5213;2638;2575
842;BENI;42;5058;2566;2492
843;BENI;43;4905;2492;2413
844;BENI;44;4746;2416;2330
845;BENI;45;4589;2338;2251
846;BENI;46;4435;2267;2168
847;BENI;47;4292;2199;2093
848;BENI;48;4167;2144;2023
849;BENI;49;4057;2095;1962
850;BENI;50;3953;2050;1903
851;BENI;51;3836;1998;1838
852;BENI;52;3704;1933;1771
853;BENI;53;3562;1867;1695
854;BENI;54;3401;1785;1616
855;BENI;55;3249;1709;1540
856;BENI;56;3101;1634;1467
857;BENI;57;2962;1564;1398
858;BENI;58;2847;1502;1345
859;BENI;59;2736;1441;1295
860;BENI;60;2632;1385;1247
861;BENI;61;2521;1327;1194
862;BENI;62;2405;1267;1138
863;BENI;63;2287;1205;1082
864;BENI;64;2169;1145;1024
865;BENI;65;2052;1085;967
866;BENI;66;1944;1024;920
867;BENI;67;1844;972;872
868;BENI;68;1760;929;831
869;BENI;69;1685;890;795
870;BENI;70;1621;856;765
871;BENI;71;1543;813;730
872;BENI;72;1461;771;690
873;BENI;73;1368;718;650
874;BENI;74;1262;662;600
875;BENI;75;1157;605;552
876;BENI;76;1073;557;516
877;BENI;77;989;510;479
878;BENI;78;901;465;436
879;BENI;79;817;420;397
880;BENI;80;5323;2561;2762
900;PANDO;0;4073;2085;1988
901;PANDO;1;4015;2056;1959
902;PANDO;2;3970;2033;1937
903;PANDO;3;3926;2012;1914
904;PANDO;4;3881;1990;1891
905;PANDO;5;3835;1969;1866
906;PANDO;6;3788;1946;1842
907;PANDO;7;3736;1919;1817
908;PANDO;8;3681;1892;1789
909;PANDO;9;3623;1861;1762
910;PANDO;10;3492;1805;1687
911;PANDO;11;3450;1777;1673
912;PANDO;12;3403;1752;1651
913;PANDO;13;3354;1727;1627
914;PANDO;14;3299;1702;1597
915;PANDO;15;3247;1678;1569
916;PANDO;16;3198;1657;1541
917;PANDO;17;3161;1649;1512
918;PANDO;18;3150;1658;1492
919;PANDO;19;3149;1673;1476
920;PANDO;20;3151;1686;1465
921;PANDO;21;3163;1703;1460
922;PANDO;22;3157;1707;1450
923;PANDO;23;3140;1709;1431
924;PANDO;24;3114;1706;1408
925;PANDO;25;3079;1704;1375
926;PANDO;26;3042;1694;1348
927;PANDO;27;2978;1667;1311
928;PANDO;28;2907;1628;1279
929;PANDO;29;2847;1588;1259
930;PANDO;30;2778;1549;1229
931;PANDO;31;2725;1517;1208
932;PANDO;32;2675;1493;1182
933;PANDO;33;2611;1455;1156
934;PANDO;34;2546;1416;1130
935;PANDO;35;2478;1374;1104
936;PANDO;36;2402;1328;1074
937;PANDO;37;2329;1286;1043
938;PANDO;38;2254;1247;1007
939;PANDO;39;2174;1206;968
940;PANDO;40;2095;1163;932
941;PANDO;41;2021;1125;896
942;PANDO;42;1938;1084;854
943;PANDO;43;1851;1038;813
944;PANDO;44;1756;988;768
945;PANDO;45;1657;936;721
946;PANDO;46;1568;889;679
947;PANDO;47;1486;847;639
948;PANDO;48;1420;811;609
949;PANDO;49;1363;780;583
950;PANDO;50;1308;751;557
951;PANDO;51;1250;720;530
952;PANDO;52;1190;687;503
953;PANDO;53;1131;654;477
954;PANDO;54;1065;618;447
955;PANDO;55;1000;580;420
956;PANDO;56;937;544;393
957;PANDO;57;884;513;371
958;PANDO;58;835;485;350
959;PANDO;59;795;462;333
960;PANDO;60;756;439;317
961;PANDO;61;718;418;300
962;PANDO;62;676;392;284
963;PANDO;63;629;366;263
964;PANDO;64;583;338;245
965;PANDO;65;539;313;226
966;PANDO;66;496;287;209
967;PANDO;67;460;265;195
968;PANDO;68;423;244;179
969;PANDO;69;392;226;166
970;PANDO;70;366;211;155
971;PANDO;71;342;198;144
972;PANDO;72;317;183;134
973;PANDO;73;295;169;126
974;PANDO;74;268;153;115
975;PANDO;75;244;138;106
976;PANDO;76;222;125;97
977;PANDO;77;204;115;89
978;PANDO;78;181;103;78
979;PANDO;79;161;90;71
980;PANDO;80;924;474;450